aaa,100,100,100,300,100.000000
bbb,90,90,90,270,90.000000
asd,151,154,123,428,142.666672
하하,0,30,10,40,13.333333
%EC%B2%A0%ED%9D%AC,25,12,65,102,34.000000
yourScore,10,5,3,18,6.000000
aaaaa,1010,123,123,1256,418.666656
yourScore,10,5,3,18,6.000000
%EC%84%9C%EC%A0%95%ED%98%81,1010,123,123,1256,418.666656
%EC%B2%98%E3%85%97%EC%B2%98%EB%9F%AC%EC%B2%A0,10,5,3,18,6.000000
처ㅗ처러철,10,5,3,18,6.000000
서정혁,100,100,100,300,100.000000
